1:1337:9999
1:22:9999
1:33232:9999
1:3223:9999
1:1337:9999
0:1337:9999
0:1337:9999
0:1337:9999
0:1337:9999
0:1337:9999


